_MK_,MK34567,Roo Kids On The Block,472,6457,6929,17,78,95,633,1723,4478,32
AmbaLaBamba,x-Kohaku,Dabaholics Anonymous,311,7746,8057,5,125,130,749,1849,5329,35
AppleKratue,AppleKratue,My Waifu Is Still Better Than Yours,184,7022,7206,6,127,133,549,1775,4749,32
Arturia,syaoran369,My Waifu Is Still Better Than Yours,524,20203,20727,1,397,398,1653,4948,13728,70
Ashbo82,Bungles--Finger,My Drinking Team Has A Trophy Problem,332,7802,8134,14,163,177,1107,1895,4955,39
AshtimusPrime,Asher1985,Game of Moans: The Second Coming,49,8618,8667,2,139,141,771,2173,5582,37
Attack-Trik,Attack-Trik,Professor V.J. Cornucopia's Fantastic Foodmagorium and Great American Steakery,490,12246,12736,11,192,203,942,3103,8488,47
Azoth658,Azoth658,Game of Moans: The Second Coming,251,15778,16029,10,189,199,1175,3373,11282,54
Bic80,Bic80,The Backdoor Bandits,495,11746,12241,16,210,226,1211,3216,7588,49
bigdrama,bigdrama,Professor V.J. Cornucopia's Fantastic Foodmagorium and Great American Steakery,441,13138,13579,15,239,254,1239,3074,9012,51
BinkUncia,BinkUncia,My Drinking Team Has A Trophy Problem,466,10091,10557,12,148,160,948,2633,6816,42
Blaze Naruto Shippuden,Leo_the_Lion25,Mighty Morphin Trophy Rangers,1574,14459,16033,50,264,314,1874,4198,9647,62
BreadSkin,BreadSkin,TBC,387,22037,22424,12,448,460,2004,5229,14731,77
broadsword93,broadsword93,Started from the bottom... and still sofa king here,258,8046,8304,8,139,147,639,1801,5717,35
C-IRVINE-94,C-IRVINE-94,The Backdoor Bandits,195,12425,12620,7,210,217,1029,2970,8404,47
Carbon_lancer,Carbon_lancer,To Infinity and Beyond,38,11331,11369,0,113,113,823,2428,8005,41
CatNZ,korncat666,Snakes in the Grass,3472,12331,15803,120,235,355,1903,4197,9348,63
cbchaos67,cbchaos67,The Backdoor Bandits,248,13572,13820,10,219,229,987,3256,9348,49
clayser,clayser,THS,656,4612,5268,14,70,84,457,1306,3421,27
Combatting,Combatting,Professor V.J. Cornucopia's Fantastic Foodmagorium and Great American Steakery,216,11294,11510,6,180,186,980,2719,7625,44
DaEastside,Da-Eastside,Roo Kids On The Block,2504,19551,22055,73,386,459,2143,5065,14388,77
DaFaztFingaz,DaFaztFingaz,Professor V.J. Cornucopia's Fantastic Foodmagorium and Great American Steakery,153,4914,5067,5,78,83,350,1084,3550,26
Dark_Adonis,Dark_Adonis,Started from the bottom... and still sofa king here,308,21049,21357,6,309,315,1471,4564,15007,68
Dark_Raven666,Dark_Raven666,Super Gamindustri 64,151,21140,21291,2,417,419,1787,5124,13961,73
Darth_Krid,Darth_Krid,Snakes in the Grass,4035,15455,19490,144,341,485,2877,5378,10750,80
Deceiver,XxDecieverxX,Super Gamindustri 64,493,7462,7955,12,125,137,518,1792,5508,33
Dino_Roar,Dino_Roar,Started from the bottom... and still sofa king here,1032,15632,16664,35,342,377,2047,4362,9878,66
DISCOKING,DISCOKING,People Doing Casual Things,315,11604,11919,14,218,232,1041,2742,7904,46
diskdocx,diskdocx,Hail to the Ping Baby,1209,23791,25000,46,517,563,3165,6524,14748,93
djhmetfan2,TrophyDad,Mighty Morphin Trophy Rangers,2191,33400,35591,59,550,609,3890,8997,22095,119
Dolken,Dolken_swe,THS,535,13066,13601,20,166,186,1130,3246,9039,50
DPatriot,DPatriot,THS,199,7037,7236,5,132,137,521,1524,5054,32
DrHambone,DrHambone,Who Needs Platinum's When You Can Get Lots of Bronzes?,508,9364,9872,13,116,129,897,2172,6674,40
Eric-B14,bubman2,The Leftovers,118,8903,9021,1,108,109,549,1850,6513,35
esstee11,esstee11,Started from the bottom... and still sofa king here,1521,3551,5072,43,76,119,765,1245,2943,30
fancyfox,Fancy_Fox,My Waifu Is Still Better Than Yours,415,15107,15522,12,260,272,1063,3270,10917,53
finally a devil,John_Smith2010,Lord of the Pings,358,5813,6171,8,67,75,360,1128,4608,28
fisty123,fisty123,My Waifu Is Still Better Than Yours,1432,16238,17670,55,306,361,2212,4519,10578,69
Foxyfox,Belle_Arelle,The Trophy Avengers,1316,4738,6054,36,80,116,656,1708,3574,31
frosteeeh21,frosteeeh21,The Leftovers,118,11033,11151,4,95,99,623,2473,7956,39
funkyweed,funkyweed,TBC,153,8381,8534,7,156,163,1007,2232,5132,39
Fynn84,Infynnity84,Team Sleep,87,1746,1833,6,18,24,156,408,1245,16
Gage,ggamer15,Snakes in the Grass,1927,29456,31383,77,570,647,4038,7963,18735,113
Gashead-64,Gashead-64,Lord of the Pings,327,3173,3500,8,51,59,333,883,2225,22
GAZDAN,GAZDAN,My Drinking Team Has A Trophy Problem,692,16258,16950,23,354,377,1834,4559,10180,65
GearsOfTheDead,GearsOfTheDead,Lord of the Pings,525,3271,3796,16,56,72,427,875,2422,24
genolas77,genolas77,Started from the bottom... and still sofa king here,648,14027,14675,23,269,292,1431,3614,9338,56
guylian,guylian,Team Sleep,148,8140,8288,3,128,131,683,1875,5599,35
HaoleDave,HaoleDave,The Leftovers,554,6271,6825,19,104,123,624,1974,4104,33
Haptism,Izularia,Super Gamindustri 64,448,12478,12926,13,221,234,1185,3321,8186,50
hBLOXs,hBLOXs,Who Needs Platinum's When You Can Get Lots of Bronzes?,598,8004,8602,11,164,175,898,1878,5651,38
HellCu3ED,HellCu3ED,To Infinity and Beyond,347,11955,12302,10,251,261,1077,2801,8163,48
honda hoe,HondaHoe,People Doing Casual Things,67,6656,6723,4,147,151,762,1927,3883,34
I Bleed Green,Quickie_Lindsay,Who Needs Platinum's When You Can Get Lots of Bronzes?,102,8130,8232,2,65,67,513,1587,6065,32
iLion,lion1325478,People Doing Casual Things,599,6624,7223,13,131,144,848,1787,4444,35
IM NaMTaB,malachi1987,The Trophy Avengers,271,7111,7382,10,75,85,571,1620,5106,32
JayPBM,JayPBM,Hail to the Ping Baby,283,13444,13727,10,223,233,1389,3385,8720,53
Jerry Appleby,Jerry_Appleby,The Trophy Avengers,430,21189,21619,12,403,415,1863,5122,14219,74
JMeeks,JMeeks1875,The Backdoor Bandits,896,11917,12813,36,221,257,1391,3437,7728,52
Joooooink,Joooooink,THS,379,14413,14792,8,158,166,976,3087,10563,50
JoyPolarTwin,Floreli,Team Sleep,335,10277,10612,12,135,147,802,2136,7527,40
jvaferreira,jvaferreira,Started from the bottom... and still sofa king here,497,8381,8878,13,124,137,521,1783,6437,35
kb420mcl,kb420mcl,Snakes in the Grass,3850,24787,28637,161,464,625,3423,7044,17545,102
kdogg2010,kdogg2010,The Leftovers,363,16676,17039,7,162,169,1203,3648,12019,56
KevlarPrime81,KevlarPrime81,Lord of the Pings,282,957,1239,7,22,29,159,240,811,14
kinjall,kinjall,My Drinking Team Has A Trophy Problem,444,7241,7685,9,130,139,651,1853,5042,34
Kratos2810,WWE_Kratos2810,My Waifu Is Still Better Than Yours,354,9006,9360,9,155,164,674,2042,6480,38
Labartu,whatev0r,TBC,511,9066,9577,9,154,163,746,2383,6285,39
Laburnski,Laburnski,My Waifu Is Still Better Than Yours,663,9017,9680,16,194,210,732,2040,6698,39
leptonic,leptonic,Mighty Morphin Trophy Rangers,1090,28316,29406,58,320,378,2604,6333,20091,92
LionSquid,Lion_Squid,Who Needs Platinum's When You Can Get Lots of Bronzes?,447,7624,8071,9,88,97,478,1546,5950,32
luffybuggy,luffybuggy,Your Bag is Full Please Remove Some Trophies to Continue,638,10448,11086,17,172,189,822,2512,7563,42
Martz,Martz4040,People Doing Casual Things,289,2538,2827,7,37,44,234,640,1909,19
mattigummi,mattigummi45,Team Sleep,277,8068,8345,7,137,144,655,1932,5614,35
Mendel,Mendel_Skimmel,TBC,425,15658,16083,11,278,289,1303,3469,11022,57
MikeKeese,MikeKeese,Snakes in the Grass,2648,21170,23818,101,423,524,2852,6095,14347,88
MikelAL93,Mikel93,Super Gamindustri 64,1089,8546,9635,21,110,131,947,2330,6227,40
Molasar,Molasar,Hail to the Ping Baby,486,13750,14236,9,232,241,971,3452,9572,50
morg106,morg106,Dabaholics Anonymous,1657,9455,11112,57,185,242,1426,3163,6281,49
Multitasking,Multi_Tasking,Lord of the Pings,352,7593,7945,5,114,119,541,1686,5599,33
neahcrow,neahcrow,Mighty Morphin Trophy Rangers,3590,12065,15655,103,141,244,1546,3712,10153,57
NemoG,NemoG,To Infinity and Beyond,92,4968,5060,1,48,49,252,910,3849,24
NightRusticDawn,NightRusticDawn,THS,408,7980,8388,10,149,159,813,1904,5512,37
Noid,The__Noid,Professor V.J. Cornucopia's Fantastic Foodmagorium and Great American Steakery,69,16406,16475,0,178,178,1217,3723,11357,55
nyannyanexpress,broheimexpress,Lord of the Pings,445,9281,9726,11,136,147,889,2330,6360,40
olsen77,olsen77,TBC,480,15011,15491,10,257,267,1221,3629,10374,55
OmegaDenmad,OmegaDenmad,Hail to the Ping Baby,614,22363,22977,26,406,432,2585,5924,14036,83
PainofDemise,PainofDemise,The Backdoor Bandits,200,5728,5928,6,83,89,427,1503,3909,29
pennysticks,ff_pennysticks,The Trophy Avengers,763,9928,10691,26,159,185,1102,2674,6730,44
RED_REBEL44,RED_REBEL44,Professor V.J. Cornucopia's Fantastic Foodmagorium and Great American Steakery,315,28515,28830,11,559,570,3054,7004,18202,99
RemingtonInk,RemingtonInk,Game of Moans: The Second Coming,24,11531,11555,0,222,222,884,2676,7773,44
Resolute,RomanClaret,Dabaholics Anonymous,520,10924,11444,19,159,178,1164,2883,7219,46
Respectable Inn,daco_1979,Who Needs Platinum's When You Can Get Lots of Bronzes?,504,17240,17744,18,330,348,1700,4051,11645,64
Rhasget,Rhasget,THS,642,9893,10535,20,191,211,1087,2565,6672,44
Robinworldwide,Robinworldwide,My Drinking Team Has A Trophy Problem,1486,15061,16547,53,225,278,1662,4091,10516,61
russelguppy,russelguppy,Who Needs Platinum's When You Can Get Lots of Bronzes?,420,10149,10569,7,102,109,752,2381,7327,40
Ryukori,JORDAN23224,Your Bag is Full Please Remove Some Trophies to Continue,544,8438,8982,20,148,168,938,1927,5949,39
saintdave,saintdave-,Your Bag is Full Please Remove Some Trophies to Continue,873,29430,30303,32,544,576,3000,7364,19363,101
Savenger,Savenger,TBC,745,14531,15276,18,279,297,1744,3852,9383,59
Sellers,CaptainSellers,Roo Kids On The Block,1272,18857,20129,50,425,475,2634,5129,11891,78
Seppukun,Seppukun,The Leftovers,196,7590,7786,4,128,132,613,1721,5320,34
Shanehi185,Shanehi185,To Infinity and Beyond,35,9254,9289,1,196,197,866,2537,5689,40
Shinobi X,kiid01,Your Bag is Full Please Remove Some Trophies to Continue,658,8920,9578,16,173,189,780,2045,6564,39
Slamma,slammajamma28,Dabaholics Anonymous,491,7577,8068,10,104,114,643,1884,5427,34
Smartbomb,smartbomb_HD,Roo Kids On The Block,552,1307,1859,17,14,31,227,399,1202,17
SNACH2497,SNACH2497,Mighty Morphin Trophy Rangers,2302,10374,12676,65,135,200,1533,3273,7670,51
snaddef,Snaddef,The Leftovers,132,7306,7438,3,96,99,504,1561,5274,32
soundsfascinating,dagobahhh,Game of Moans: The Second Coming,6,2365,2371,0,19,19,204,503,1645,17
staytrue1985,staytrue1985,The Backdoor Bandits,459,7427,7886,18,144,162,894,1871,4959,37
stgermain,stgermain,Super Gamindustri 64,450,20948,21398,19,419,438,2272,5572,13116,77
SylarTheNinja,SylarTheNinja,Game of Moans: The Second Coming,65,9033,9098,1,132,133,618,2151,6196,36
Szapako,Szapako,Team Sleep,158,4367,4525,5,63,68,328,1009,3120,24
THE-123-GAMER,THE-123-GAMER,Roo Kids On The Block,428,15343,15771,8,195,203,1045,3377,11146,53
TheManUtdFan,FeXcEz-_-Sk1lLzz,Dabaholics Anonymous,562,20015,20577,19,341,360,1880,4993,13344,71
themindisacity,themindisacity,Hail to the Ping Baby,1201,16151,17352,35,339,374,2060,4457,10461,67
ThePriceysRight,ThePriceysRight,Roo Kids On The Block,1238,4188,5426,48,118,166,1230,1783,2247,35
TheRealClayman,TheRealClayman,Hail to the Ping Baby,1799,18988,20787,46,334,380,1799,4951,13657,71
TiNnyzEuS,TiNnyzEuS,To Infinity and Beyond,117,5438,5555,5,100,105,490,1454,3506,29
trophiehunter,Vapion,The Trophy Avengers,558,10827,11385,18,74,92,854,2065,8374,41
TuckNorris85,TuckNorris85,People Doing Casual Things,427,4001,4428,10,61,71,347,846,3164,24
tuffmuff,tuffmuff,Snakes in the Grass,3135,20816,23951,103,444,547,3736,6543,13125,95
TwilightStar,TwilightStar-R,Super Gamindustri 64,285,5408,5693,7,102,109,558,1426,3600,29
twyz,twyz,People Doing Casual Things,542,8081,8623,12,122,134,665,1947,5877,36
VazzVegas,VazzVegas,Your Bag is Full Please Remove Some Trophies to Continue,508,7577,8085,9,142,151,728,2095,5111,36
Velvet,Blood_Velvet,Dabaholics Anonymous,226,11628,11854,5,168,173,1059,2862,7760,46
Vo1cl,Vo1cl,Game of Moans: The Second Coming,69,17956,18025,0,276,276,1466,4265,12018,62
wrestlefanatic77,wrestlefanatic77,Mighty Morphin Trophy Rangers,779,12244,13023,11,162,173,999,3106,8745,47
Xander45,Hemming87,My Drinking Team Has A Trophy Problem,627,27555,28182,22,384,406,2200,6233,19343,88
XquietusX,XquietusX,To Infinity and Beyond,174,23657,23831,1,388,389,1729,5365,16348,76
xTSx Kezza,Kittikat_Kezza,The Trophy Avengers,144,935,1079,1,5,6,61,210,802,13
xxRC85xx,xxRC85xx,Your Bag is Full Please Remove Some Trophies to Continue,1184,12393,13577,40,277,317,2060,3703,7497,59
Zetberg,Zetberg,Team Sleep,1186,18000,19186,44,338,382,2107,4753,11944,71
